####################
#..#########.......#
#..#########....I..#
#..###OO####.......#
#...N..............#
#............#######
#.N..........#.....#
#..................#
#............#I....#
#............#######
######.............#
#....#.............#
#N.................#
######.............#
#..................#
#######......#######
#.....#......#I....#
#.................N#
#N....#......#.....#
####################



