##########
#.##.#####
#.##....##
####.....#
#.N......#
#........#
#.N......#
#........#
#........#
#######...