####################
#...........########
#...E......E..######
#................###
#...####...........#
#...####..E........#
#..................#
#....####.......####
#....####.......O###
#...............O###
#........E......####
#..................#
#...............II.#
#........###.......#
#........###.......#
#...###............#
#...###......#######
#.............II...#
#......##..........#
####################