####################
#..##########....###
#..##########....###
#..####HH####....###
#...........II.....#
#.......E..........#
#..................#
#..................#
#.............E....#
#..................#
#........E.........#
#.II...............#
#..II...........EE.#
##.......###.......#
###......###.......#
#####..............#
######.............#
#######......II....#
########.....II....#
####################