####################
#.........##########
#...E.......########
#.............######
#...####.........###
#...####..E.......##
#..................#
#...............####
#...............O###
#...............O###
#........E......####
#....E.............#
#..............I.I.#
#........###.......#
##.......###.......#
###................#
####.....I....I....#
#####..............#
#######.....II...I.#
####################